############
#        O #
#   P   ####
#       X  #     #######
#######    #     #O    #
#  O ##    #######     ####
#    ## X                 #
#                     O   #
#       XX ################
#       #  #
############