#######
#  P  #
#     #
#X  O #
#######
            #######
            #     #
            # X   #
            #    O#
            #######