##########################################
#P                                       #
#           X                            #
######################################   #
#                                        #
#                                        #
#   ######################################
#                                        #
#                                        #
######################################   #
#                                        #
#                                        #
#   ######################################
#                                        #
#                                        #
######################################   #
#                                        #
#                                        #
#   ######################################
#                                        #
#                                       O#
##########################################