        #
       # #
      #   #
     #     #
#####       #####
 #      P      #
  #           #
   #    X    #
  #       O   #
 #             #
#####       #####
     #     #
      #   #
       # #
        #